Alfred	Hitchcock USA
Jack	Clayton USA
David	Lean USA
Michael	Cimino USA
Milos	Forman USA
Ridley	Scott USA
Stanley	Kubrick USA
Bryan	Singer USA
Roman	Polanski Polonia
Woody	Allen USA
Hayao	Miyazaki Giappone
Frank	Darabont Francese
James	Cameron USA
John	Boorman USA
Danny	Boyle USA
Christopher	Nolan USA
Richard	Kelly USA
Kevin	Spacey USA
Andrei	Tarkovsky Russia
Roberto Benigni Italia